*^*****************************#
* **      *      ****         *#
*  * *** ** **** *    ******* *#
* ** * * *     * * ** *     * *#
*    * * * ***** *    * *** * *#
****** * ***   * **** *   * * *#
*    *       *        *** *   *#
**** ************** * *   *****#
*      *          * * *****   *#
* ****** ******** * *       * *#
*        *        * **** ******#
*** **** * ******** *    *    *#
* * *  * * *   *  * ********* *#
* * *  * *   *   **           *#
* * ** * ********** * *********#
*      *            * *   *   *#
****** ************** * *   * *#
*      *     **   * * ******* *#
******** *** *  *             *#
*      *   * * ****************#
* ****** ***   *     **********#
*        ******* *** *      ***#
* ********   *   *   * ** * * *#
*          *   * * ****** *   *#
******* ******** *        *** *#
*     * *      * **********   *#
* ** ** * ****** *****    * * *#
*  *    *        *   **** *** *#
** ***************** *  *   * *#
*    *   *           * **** * *#
* **   *   * ****** **    *   *#
*******************$***********#